1,7798160000000,Cordero con piel de lobo Cabernet Sauvignon,6,0,6,100,680,VM,
2,7792800000000,Pat. abrazo de oso,30,0,30,100,230,Cerveza,
3,7790980000000,Marques dulce tardio,4,0,4,100,350,VM,
4,7792800000000,Patagonia hoppy lager 730cc,6,1,5,208,390,Cerveza,
5,7792800000000,Patagonia 24.7 410cc,36,12,24,144,230,Cerveza,
6,7792800000000,Andes rubia,6,0,6,120,190,Cerveza,
7,7792800000000,Andes ipa andina,12,2,10,116,200,Cerveza,
8,7798340000000,Rabieta red honey,12,5,7,141,240,Cerveza,
9,7798340000000,Pampa cream stout,6,2,4,128,240,Cerveza,
10,7790720000000,Novecento Raices Malbec,8,0,8,283,530,VM,
11,7798140000000,Eugenio Bustos Malbec,8,0,8,217,400,VM,
12,7798130000000,Cuesta del Madero Malbec 2021,8,0,8,200,380,VM,
13,7790900000000,Agua Benedictino 600ml,70,57,13,63,110,Agua,
14,7790900000000,Aquarius manzana ,12,12,0,0,140,Agua saborizada,
15,7790900000000,Aquarius Pomelo,24,15,9,0,140,Agua saborizada,
16,7790900000000,Aquarius Pomelo Rosado,12,12,0,0,140,Agua saborizada,
17,7891140000000,Aperol,9,2,7,573,1100,Aperitivo,
18,7891140000000,Campari,7,5,2,600,1000,Aperitivo,
19,7790290000000,Carpano Bianco ,3,1,2,161,600,Aperitivo,
20,7790290000000,Carpano Rosso ,3,3,0,161,600,Aperitivo,
21,7791200000000,Cinzano ,3,1,2,363,700,Aperitivo,
22,7791200000000,Cynar,3,1,2,446,800,Aperitivo,
23,7790950000000,Dr. Lemon con limon ,16,2,14,218,420,Aperitivo,
24,7790950000000,Dr. Lemon con vodka ,12,9,3,218,420,Aperitivo,
25,7790290000000,Fernet Branca ,227,213,14,0,1300,Aperitivo,
26,7791540000000,Frizze Blue,12,5,7,233,420,Aperitivo,
27,7790950000000,Gancia,18,10,8,0,650,Aperitivo,
28,7790950000000,Gancia Frutos Rojos,6,6,0,195,480,Aperitivo,
29,7790950000000,Gancia Red Bitter,6,0,6,344,600,Aperitivo,
30,7792800000000,Andes Roja 473cc,54,49,5,0,200,Cerveza,
31,7792800000000,Botella de agua + 2 porrones corona,3,3,0,0,2160,Cerveza,
32,7792800000000,Brahma + Lona playera,2,0,2,0,2640,Cerveza,
33,7792800000000,Brahma 473cc,72,83,11,0,0,Cerveza,
34,7792800000000,Budweiser 410cc,180,138,42,100,170,Cerveza,
35,7792800000000,Corona 330cc,96,65,31,0,300,Cerveza,
36,7793150000000,Heineken 473cc,180,122,58,152,260,Cerveza,
37,7793150000000,Heineken bot. 330cc,24,4,20,121,260,Cerveza,
38,7793150000000,Imperial amber lager 473cc,24,0,24,134,190,Cerveza,
39,7793150000000,Imperial Golden 473cc,120,103,17,0,240,Cerveza,
40,7793150000000,Imperial IPA 473cc,48,2,46,134,240,Cerveza,
41,7793150000000,Imperial Negra 473cc,48,48,0,0,0,Cerveza,
42,7793150000000,Miller 473cc,48,28,20,0,0,Cerveza,
43,7798340000000,Pampa Amber 473cc,16,10,6,185,240,Cerveza,
44,7798340000000,Pampa Dorada 473cc,12,9,3,185,240,Cerveza,
45,7798340000000,Pampa IPA 473cc,12,6,6,185,240,Cerveza,
46,7792800000000,Patagonia Amber Lager 410cc,96,85,11,0,230,Cerveza,
47,7792800000000,Patagonia Amber Lager 730cc,60,50,10,0,390,Cerveza,
48,7792800000000,Patagonia Bohemian 473cc,25,25,0,0,0,Cerveza,
49,7792800000000,Patagonia Bohemian 710cc,42,40,2,0,390,Cerveza,
50,7792800000000,Patagonia Bohemian Pilsener 410cc,48,9,39,0,210,Cerveza,
51,7792800000000,Patagonia Knine 710cc,48,38,10,0,390,Cerveza,
52,7792800000000,patagonia sendero sur 473cc,48,48,0,0,0,Cerveza,
53,7792800000000,Patagonia Weisse 473cc,57,57,0,0,0,Cerveza,
54,7792800000000,Patagonia Weisse 710cc,48,48,0,0,0,Cerveza,
55,7792800000000,Quilmes Rubia 473cc,48,22,26,0,180,Cerveza,
56,7793150000000,Salta Negra 473cc,42,42,0,0,160,Cerveza,
57,7793150000000,Salta Rubia 473cc,42,28,14,0,160,Cerveza,
58,7793150000000,Schneider 473cc,36,4,32,0,0,Cerveza,
59,7793150000000,Schneider Negra 473cc,24,24,0,0,0,Cerveza,
60,7792800000000,Stella Artois 473cc,144,119,25,142,240,Cerveza,
61,7792800000000,temple cosmica 473cc,24,20,4,0,220,Cerveza,
62,7792800000000,temple scottish 473cc,48,24,24,0,220,Cerveza,
63,7792800000000,temple wolf IPA 473,48,22,26,0,240,Cerveza,
64,7891160000000,copa barone 490ml,12,8,4,400,900,Cristaleria,
65,7891160000000,copa brunello 490ml,12,12,0,400,900,Cristaleria,
66,7891160000000,Copa champagne 210ml nadir,2,0,2,299,500,Cristaleria,
67,7891160000000,Copa gin lisa 600ml,2,2,0,590,960,Cristaleria,
68,1516300000000,Copa VM KSA ,2,2,0,450,720,Cristaleria,
69,copasb,Copas Beefeater,2,2,0,780,1680,Cristaleria,
70,copast,Copas Gin Tanqueray,2,1,1,815,1600,Cristaleria,
71,7792800000000,Set x3 Copas Stella Artois vintage,2,1,1,0,5000,Cristaleria,
72,6953440000000,Vaso whisky 255ml,6,4,2,250,500,Cristaleria,
73,1007080000000,Monster original,24,24,0,0,240,Energizante,
74,1007080000000,Monster yellow 473ml,24,24,0,0,240,Energizante,
75,7798120000000,Speed 250ml,24,24,0,78,0,Energizante,
76,7798120000000,Speed 473cc,48,20,28,150,240,Energizante,
77,7798120000000,speed 500cc,12,12,0,140,0,Energizante,
78,7790720000000,2020 LPQTP,11,0,11,0,720,Espumante,
79,7790700000000,Bianchi Extra Brut,4,4,0,420,700,Espumante,
80,7798130000000,Champenoise Blanc de Blancs,12,5,7,1385,2340,Espumante,
81,7790980000000,Chandon Delice 750ml,6,3,3,1150,1500,Espumante,
82,7790950000000,Chaumont Extra brut,6,6,0,0,0,Espumante,
83,7791200000000,Cinzano pro0spritz,6,0,6,0,1140,Espumante,
84,7791540000000,Dada 7 maracuya 750ml ,12,1,11,660,1100,Espumante,
85,7791540000000,Dada 7 Sweet Pink,3,3,0,706,1100,Espumante,
86,7798130000000,Espumante Chayarmuyo Pinot noir Rose,6,2,4,1065,1740,Espumante,
87,7791560000000,Mumm Extra brut,6,3,3,450,1000,Espumante,
88,7791250000000,Navarro Correas Extra Brut,15,4,11,0,1300,Espumante,
89,7790120000000,Sidra 1888,12,2,10,354,780,Espumante,
90,7790900000000,Coca Cola 3L ,227,210,17,0,390,Gaseosa,
91,7790900000000,Coca cola sin azucar 1.5L,18,8,10,160,250,Gaseosa,
92,7790900000000,Coca0cola 1.5L,24,7,17,160,250,Gaseosa,
93,7790900000000,Coca0cola 500ml,12,6,6,100,150,Gaseosa,
94,7790640000000,Cunnington tonica 1.5 L,36,18,18,120,200,Gaseosa,
95,7791810000000,Paso de los Toros Pomelo 1.5L,34,25,9,153,240,Gaseosa,
96,7791810000000,Paso de los Toros Tonica 1.5L,31,25,6,153,240,Gaseosa,
97,7791810000000,Paso de los Toros Tonica 269ml,69,28,41,50,90,Gaseosa,
98,7790900000000,Schweppes,52,52,0,133,210,Gaseosa,
99,7790900000000,Schweppes 354ml ,24,24,0,100,156,Gaseosa,
100,7798070000000,Sierra de los padres 1.5L,6,6,0,100,0,Gaseosa,
101,7790900000000,Sprite 1,5L,36,28,8,130,250,Gaseosa,
102,7790900000000,Sprite zero 1.5L,6,3,3,98,230,Gaseosa,
103,6127800039574b,500 noches blue,3,0,3,1480,2100,Gin,
104,6127800000000,500 noches london dry,3,0,3,1480,2100,Gin,
105,6127800000000,500 noches pink,3,1,2,1480,2100,Gin,
106,89540507583,Beefeater 24,6,1,5,0,6200,Gin,
107,5000300000000,Beefeater Dry Gin ,11,11,0,0,3000,Gin,
108,5000300000000,Beefeater Pink ,3,3,0,0,0,Gin,
109,ginbols,Bols ,4,3,1,0,720,Gin,
110,7640180000000,Bombay ,20,16,4,1860,4200,Gin,
111,656751000000,Bosque,2,2,0,1400,0,Gin,
112,7792410000000,Brighton gin 700ml,4,2,2,730,1350,Gin,
113,897076000000,Bulldog,3,3,0,3200,5400,Gin,
114,7798350000000,Gin terrier citric 750ml,1,0,1,1550,2300,Gin,
115,7798350000000,Gin terrier pink 750ml,1,1,0,1550,2300,Gin,
116,7798350000000,Gin terrier spicy 750ml,1,0,1,1550,2300,Gin,
117,5000290000000,Gordons 700ml ,3,1,2,0,1650,Gin,
118,7791250000000,Gordons,11,11,0,0,1650,Gin,
119,7798140000000,Heraclito dry gin,3,0,3,1025,1800,Gin,
120,754698000000,Heredero,2,2,0,1613,2500,Gin,
121,724751000000,Heredero gin 725ml,2,2,0,1613,2500,Gin,
122,7791560000000,Hiram Walker gin 1L,2,0,2,0,1000,Gin,
123,8411140000000,Larios gin mediterraneo,2,1,1,1500,2500,Gin,
124,8411140000000,Larios Rose gin,11,9,2,1800,2900,Gin,
125,724751000000,Malandra Gin 500ml,45,28,17,640,1200,Gin,
126,7798290000000,Maleficio Dry gin,3,2,1,716,1350,Gin,
127,7798290000000,Maleficio Honey ,3,0,3,871,1350,Gin,
128,7798290000000,Maleficio Pink,3,2,1,871,1350,Gin,
129,7798200000000,Principe de los Apostoles,2,2,0,1648,2600,Gin,
130,7798200000000,Principe de los apostoles 750ml,4,3,1,1650,2600,Gin,
131,ginriojano,Rinia,8,5,3,1100,1650,Gin,
132,5000280000000,Tanqueray,4,0,4,0,3430,Gin,
133,7790900000000,Ades 200ml durazno,6,1,5,65,100,Jugo,
134,7790900000000,Ades 200ml frutas tropicales,6,3,3,65,100,Jugo,
135,7790900000000,Ades 200ml manzana,6,6,0,65,100,Jugo,
136,7790040000000,Baggio Multifruta,16,16,0,0,0,Jugo,
137,7798290000000,Big C durazno,8,8,0,0,0,Jugo,
138,7790900000000,Bot Cepita durazno 1L,12,5,7,130,200,Jugo,
139,7790900000000,Cepita 200ml multifruta,6,1,5,45,80,Jugo,
140,7790900000000,Cepita 200ml naranja ,6,3,3,45,80,Jugo,
141,7790900000000,Cepita bot naranja 1L,20,20,0,120,200,Jugo,
142,7790900000000,Jugo Cepita Manzana 1L,63,36,27,116,200,Jugo,
143,7790900000000,Jugo Cepita Multifruta 1L,41,20,21,116,200,Jugo,
144,7790900000000,Jugo Cepita Naranja 1L,60,52,8,116,200,Jugo,
145,5011010000000,Baileys,12,7,5,2110,3200,Licor,
146,7791090000000,Hesperidina ,2,2,0,520,1020,Licor,
147,4067700000000,Jagermeister,2,2,0,1800,3000,Licor,
148,auricular,Auricular + parlante brahma ,2,1,1,0,1800,Regaleria,
149,bandejabud,Bandeja Budweiser roja,6,0,6,0,1440,Regaleria,
150,8904000000000,Frapera acero inox.,2,0,2,1267,3000,Regaleria,
151,Fraperabudweiser,Frapera Budweiser,2,2,0,0,3120,Regaleria,
152,7501010000000,Bacardi carta blanca 1L ,3,3,0,1660,2200,Ron,
153,7501010000000,Bacardi Carta Oro 750ml,3,1,2,1175,1800,Ron,
154,7501010000000,Bacardi Ron Carta Blanca 750ml,3,1,2,1175,1800,Ron,
155,8501110000000,Havana Club 3 anios 750cc,4,2,2,825,1700,Ron,
156,7891050000000,Malibu 750ml,3,2,1,1500,2500,Ron,
157,89540468709,Malibu 750ml,2,1,1,1500,2500,Ron,
158,7790310000000,3D sabor queso 47gr,4,4,0,92,160,Snack,
159,7790310000000,3D sabor queso 95gr,3,3,0,169,260,Snack,
160,7790310000000,Cheetos queso 47gr,8,7,1,100,160,Snack,
161,7790310000000,Cheetos queso 94gr,9,9,0,192,300,Snack,
162,7790310000000,Doritos queso 45gr,11,11,0,115,190,Snack,
163,7790310000000,Doritos queso 85gr,14,10,4,225,340,Snack,
164,7892840000000,Doritos queso 85gr,5,5,0,225,340,Snack,
165,7790310000000,Lays asado 85gr,3,3,0,192,300,Snack,
166,7790310000000,Lays cebolla caramelizada 41gr,4,4,0,100,170,Snack,
167,7790310000000,Lays clasicas 20gr,6,6,0,54,0,Snack,
168,7790310000000,Lays clasicas 45gr,16,16,0,100,160,Snack,
169,7790310000000,Lays clasicas 94gr,15,9,6,192,300,Snack,
170,7790310000000,Lays jamon serrano 85gr,7,7,0,192,300,Snack,
171,7790310000000,Lays ketchup 85gr,13,11,2,192,300,Snack,
172,7790310000000,Lays limon ,3,3,0,192,300,Snack,
173,7790310000000,Lays queso y cebolla 85gr,8,3,5,192,300,Snack,
174,7790310000000,Lays queso y pimienta 41gr,3,3,0,107,170,Snack,
175,7790310000000,Lays queso y pimienta 85gr,6,4,2,192,300,Snack,
176,7790310000000,Twistos mini jamon 40gr,9,9,0,96,140,Snack,
177,7790310000000,Twistos mini queso 40gr,9,5,4,96,140,Snack,
178,7501040000000,Jose Cuervo Blanco ,1,0,1,3202,6000,Tequila,
179,7501040000000,Jose Cuervo Dorado ,1,1,0,3202,6000,Tequila,
180,7790260000000,Tequila conquistador,3,0,3,950,1800,Tequila,
181,7798090000000,Aime Malbec,8,8,0,275,420,VM,
182,7798090000000,Aime Red Blend,1,1,0,305,500,VM,
183,7790240000000,Alaris blanco dulce,3,1,2,370,600,VM,
184,7790240000000,Alaris malbec,6,1,5,315,500,VM,
185,7790240000000,Alma mora cabernet sauvignon,3,2,1,415,660,VM,
186,7790240000000,Alma Mora Chardonnay,5,5,0,415,660,VM,
187,7790240000000,Alma Mora malbec,22,15,7,415,660,VM,
188,7798120000000,Andeluna Altitud Malbec,3,0,3,840,1600,VM,
189,7798120000000,Andeluna Raices Malbec,3,1,2,455,900,VM,
190,7790840000000,Arrogante Bodg. Vicentin,3,0,3,0,2400,VM,
191,7798110000000,Azul Malbec,3,1,2,495,800,VM,
192,7798000000000,Baudron Malbec,2,2,0,399,780,VM,
193,7798000000000,Baudron Reservado,2,2,0,462,1080,VM,
194,7793440000000,Benjamin malbec,3,3,0,270,444,VM,
195,7795230000000,Bosco Malbec,9,6,3,371,1000,VM,
196,7798120000000,By the Glass chardonnay,2,0,2,1680,3000,VM,
197,7798120000000,By the Glass Malbec 3L,5,5,0,2160,3000,VM,
198,7798120000000,By the Glass Red blend,2,2,0,1680,3000,VM,
199,7790090000000,Cafayate Malbec,15,6,9,350,570,VM,
200,7790090000000,Cafayate Torrontes Dulce tard.,3,3,0,400,560,VM,
201,7798110000000,Callia cabernet sauvignon ,2,2,0,265,460,VM,
202,7798110000000,Callia malbec,27,27,0,260,430,VM,
203,7798110000000,Callia new malbec,4,0,4,265,570,VM,
204,7798110000000,Callia syrah cabernet,2,2,0,265,460,VM,
205,7798040000000,Casillero del Diablo res. ,3,2,1,540,1500,VM,
206,7798250000000,Castore Bonarda,6,2,4,960,1850,VM,
207,7798250000000,Castore Malbec,12,8,4,960,1850,VM,
208,7798120000000,Chac Chac Sauvignon,3,0,3,600,980,VM,
209,7791840000000,Chacabuco cabernet sauvignon,4,0,4,200,480,VM,
210,7791840000000,Chacabuco malbec,3,3,0,320,540,VM,
211,7798130000000,Chaniarmuyo Gran VM Cabernet Franc,6,4,2,998,1900,VM,
212,7798130000000,Chaniarmuyo Gran VM Malbec,48,31,17,998,1900,VM,
213,7798130000000,Chaniarmuyo varietal Chardonnay,6,4,2,725,1450,VM,
214,7798130000000,Chaniarmuyo varietal malbec,36,26,10,725,1450,VM,
215,7798130000000,Chaniarmuyo Vinia providencia Malbec,6,4,2,1941,3900,VM,
216,7790420000000,Circus malbec,8,3,5,367,600,VM,
217,7798160000000,Cordero con Piel de Lobo malbec,36,31,5,388,680,VM,
218,7798130000000,Cuesta del Madero R. Malbec,3,3,0,236,528,VM,
219,7791540000000,Dada art malbec,6,1,5,395,590,VM,
220,7791540000000,Dada n8 chocolate blend,10,6,4,395,590,VM,
221,7791540000000,Dada Sweet Pink lata,24,16,8,220,350,VM,
222,7790980000000,Desigual Malbec,3,3,0,280,492,VM,
223,7790310000000,Dilema blanco dulce,3,3,0,275,468,VM,
224,7790310000000,Dilema day malbec,9,5,4,406,560,VM,
225,7790190000000,Don David malbec,7,4,3,625,990,VM,
226,7795230000000,Donde manda capitan Malbec,12,8,4,330,650,VM,
227,7798130000000,El Apostador Blend,6,1,5,800,1200,VM,
228,7798130000000,El bribon Malbec ,11,2,9,0,1200,VM,
229,7798130000000,El Canalla Blend ,6,2,4,1300,1920,VM,
230,7790840000000,El Contrabandista Petit Verdot,6,2,4,1400,1920,VM,
231,7798370000000,El Gordo Motoneta Malbec,9,9,0,385,744,VM,
232,7798130000000,El Guapo Cabernet franc,6,0,6,800,1200,VM,
233,7791540000000,El que rie ultimo rie mejor,6,1,5,688,1150,VM,
234,7790840000000,El Renegado Cabernet Sauvignon,11,1,10,1400,1920,VM,
235,7790840000000,El Tramposo Cabernet Franc,6,1,5,1400,1920,VM,
236,7790190000000,Elementos Cabernet Sauvignon,3,3,0,262,468,VM,
237,7790190000000,Elementos malbec,28,19,9,373,580,VM,
238,7793440000000,Emilia cabernet sauvignon,1,1,0,375,648,VM,
239,7793440000000,Emilia malbec,2,2,0,375,648,VM,
240,7790420000000,Escorihuela gascon malbec,4,1,3,895,1620,VM,
241,7798110000000,Esperado callia cabernet sauvignon,4,0,4,285,590,VM,
242,7790310000000,Estancia mendoza reserva malbec,3,0,3,290,1050,VM,
243,7798120000000,Exploracion malbec las perdices,4,2,2,1190,2200,VM,
244,7798060000000,F. Monte flores Malbec,3,0,3,553,1200,VM,
245,7798000000000,Fabre Montmanyou reserva cab. franc,3,0,3,190,700,VM,
246,laseis,Finca la seis ,6,5,1,700,1100,VM,
247,7790240000000,Finca las Moras Malbec,3,0,3,315,490,VM,
248,7798150000000,Giramundo cabernet sauvignon,1,0,1,0,1800,VM,
249,7798080000000,Go Malbec,3,0,3,532,850,VM,
250,7790950000000,Gran Nina Cabernet Franc,6,3,3,983,1820,VM,
251,7790950000000,Gran nina malbec,6,2,4,1030,1820,VM,
252,7790950000000,Gran Nina Petit Verdot ,12,7,5,983,1820,VM,
253,7795230000000,Guanaco West blend,6,6,0,182,360,VM,
254,7798000000000,Hormiga negra malbec,8,8,0,370,540,VM,
255,7798070000000,Killka malbec,4,0,4,420,990,VM,
256,7791540000000,La gran nacha,14,7,7,476,700,VM,
257,7791200000000,La Linda Chardonnay,3,0,3,462,1050,VM,
258,7791200000000,La Linda Malbec,3,3,0,476,1050,VM,
259,7798100000000,La puerta alta malbec,18,13,5,429,680,VM,
260,7798100000000,La puerta cabernet sauvignon,12,6,6,297,450,VM,
261,7798100000000,La puerta malbec,42,42,0,297,450,VM,
262,7798100000000,La puerta syrah,12,7,5,302,460,VM,
263,7798120000000,Las perdices malbec,4,0,4,550,1100,VM,
264,7798120000000,Las Perdices res. Malbec,14,6,8,800,1620,VM,
265,7791250000000,Los arboles malbec,20,13,7,350,510,VM,
266,7791840000000,Los haroldos Estate blend,4,0,4,425,740,VM,
267,7791540000000,Los intocables malbec,7,3,4,822,1200,VM,
268,7798160000000,Lucky Wine Blend,3,3,0,175,348,VM,
269,742833000000,Maleante Malbec,9,9,0,358,648,VM,
270,7798060000000,Maleante Red blend,3,0,3,336,620,VM,
271,milvientosbonarda,Mil vientos bonarda,6,0,6,708,1220,VM,
272,milvientosmalbec,Mil vientos malbec,6,0,6,708,1220,VM,
273,milvientosmalbecreserva,Mil vientos malbec reserva,6,1,5,1026,1890,VM,
274,7798160000000,Mosquita Muerta Blend ,3,3,0,1274,3420,VM,
275,7790720000000,Nave 0 Dante robino,2,2,0,300,480,VM,
276,7793440000000,Nieto Senetiner Cabernet Sauvignon,3,1,2,455,850,VM,
277,7790950000000,Nina Dulce Natural Malbec,24,10,14,358,670,VM,
278,7790950000000,Nina Dulce Natural Moscato Giallo,42,25,17,387,670,VM,
279,7790950000000,Nina Gold blend,6,1,5,550,980,VM,
280,7790950000000,Nina Gold Cabernet Franc,6,1,5,550,980,VM,
281,7790950000000,Nina Gold Malbec,36,24,12,550,980,VM,
282,7790950000000,Nina Gold Petit Verdot,12,6,6,550,980,VM,
283,7790950000000,Nina Gold Torrontes,12,9,3,550,980,VM,
284,7790950000000,Nina Special Blend Blanco ,6,1,5,660,1230,VM,
285,7790950000000,Nina Special Blend Rose,6,3,3,660,1230,VM,
286,7790950000000,Nina Special Blend tinto,6,1,5,659,1230,VM,
287,7792320000000,Norton Cosecha Tardia Blanco Dulce ,7,3,4,297,468,VM,
288,717889000000,Norton Privada Family Blend ,6,0,6,1500,2300,VM,
289,7790720000000,Novecento malbec,12,10,2,390,500,VM,
290,7798050000000,Omnium cabernet sauvignon,4,0,4,240,520,VM,
291,7798050000000,Omnium malbec,8,2,6,240,520,VM,
292,7795230000000,Otro loco mas ice,3,0,3,590,750,VM,
293,7795230000000,Otro Loco mas Malbec,27,22,5,350,610,VM,
294,7795230000000,Parece pero no Malbec,6,3,3,490,700,VM,
295,7798120000000,Partridge Cabernet Sauvignon,3,3,0,360,600,VM,
296,7798160000000,Perro Callejero,10,8,2,495,940,VM,
297,7798120000000,Piattelli Res. Malbec 2019,9,5,4,1590,2100,VM,
298,7798120000000,Piattelli reserva salta malbec,3,0,3,1590,2100,VM,
299,7798080000000,Piedra Negra Organic Malbec,3,0,3,623,990,VM,
300,7798160000000,Pispi Blend ,6,1,5,825,2100,VM,
301,7798070000000,Portillo malbec,4,0,4,315,700,VM,
302,7790270000000,Raza argentina malbec,3,3,0,520,900,VM,
303,7790950000000,Sade blanco dulce natural,6,1,5,336,570,VM,
304,7790950000000,Sade Malbec,18,11,7,320,570,VM,
305,7798070000000,Salentein Reserva Malbec,3,2,1,761,1740,VM,
306,7790950000000,San huberto reserva,12,8,4,351,630,VM,
307,7791250000000,San telmo malbec,6,5,1,260,410,VM,
308,7791730000000,Santa Julia Chenin Dulce,58,30,28,440,750,VM,
309,7791730000000,Santa Julia Dulce Natural Tinto 269ml,12,9,3,106,220,VM,
310,7791730000000,Santa julia malbec,9,3,6,380,590,VM,
311,7791730000000,Santa Julia Organic 269ml,12,11,1,122,220,VM,
312,7798160000000,Sapo de otro pozo ,3,1,2,1050,2500,VM,
313,7798120000000,Saurus estate malbec,3,0,3,290,1020,VM,
314,7798140000000,Serbal Cabernet Franc,3,1,2,560,1020,VM,
315,7798140000000,Serbal Malbec,3,0,3,560,1020,VM,
316,7792320000000,Sexy fish cabernet franc,3,3,0,410,684,VM,
317,7798130000000,Sottano Blend ,3,0,3,600,1080,VM,
318,7798130000000,Sottano Cabernet Sauvignon,6,0,6,700,1080,VM,
319,7798130000000,Sottano Chardonnay,3,0,3,0,1080,VM,
320,7798130000000,Sottano Malbec ,6,3,3,0,1080,VM,
321,7798130000000,Sottano Merlot,3,0,3,600,1080,VM,
322,7798130000000,Sottano Reserva Blend ,3,0,3,1300,1800,VM,
323,7798130000000,Sottano Reserva Cabernet Sauvignon ,3,0,3,1300,1800,VM,
324,7798130000000,Sottano Reserva de Familia Malbec 2018,3,1,2,0,2400,VM,
325,7798130000000,Sottano Reserva Malbec,3,1,2,0,1800,VM,
326,7798060000000,Tradicion Malbec,3,3,0,364,612,VM,
327,trescopasblanco,Tres copas malbec,12,7,5,533,960,VM,
328,trescopasnegro,Tres copas malbec,12,7,5,533,960,VM,
329,7798040000000,Tribu Dulce,8,4,4,470,720,VM,
330,7798040000000,Tribu Malbec,3,3,0,338,660,VM,
331,7790950000000,Ugarteche malbec,6,1,5,350,520,VM,
332,7790950000000,Ugarteche seleccion del enologo ,6,1,5,350,520,VM,
333,7798130000000,Urban Malbec,3,3,0,375,720,VM,
334,7798060000000,Vive Cabernet Sauvignon,3,0,3,539,950,VM,
335,7791730000000,Zuccardi Q malbec,3,0,3,850,3100,VM,
336,7312040000000,Absolut Apeach,2,2,0,0,3900,Vodka,
337,7312040000000,Absolut Grapefruit,2,2,0,0,3900,Vodka,
338,7312040000000,Absolut Mandrin,3,0,3,0,3500,Vodka,
339,7312040000000,Absolut pears,3,2,1,0,3500,Vodka,
340,7312040000000,Absolut Regular (descontinuado),1,1,0,0,0,Vodka,
341,7312040000000,Absolut regular 700ml,1,1,0,0,3420,Vodka,
342,84380422041,Pravda,3,0,3,0,9700,Vodka,
343,7790290000000,Sernova Apple Pear,3,0,3,0,990,Vodka,
344,7790290000000,Sernova Berries,3,3,0,0,990,Vodka,
345,7790290000000,Sernova Citrus ,3,1,2,0,990,Vodka,
346,7790290000000,Sernova Regular ,12,5,7,540,990,Vodka,
347,7790290000000,Sernova Tropical Passion ,3,2,1,0,990,Vodka,
348,7791200000000,Skyy Apricot,2,2,0,650,1170,Vodka,
349,7791200000000,Skyy Coconut,13,9,4,650,1170,Vodka,
350,7791200000000,Skyy passion fruit,4,3,1,680,1170,Vodka,
351,7791200000000,Skyy Pineapple ,10,8,2,650,1170,Vodka,
352,7791200000000,Skyy Rasberry,8,8,0,650,1170,Vodka,
353,7791200000000,Skyy Regular ,13,5,8,0,1170,Vodka,
354,7791250000000,Smirnoff Citric lima & pomelo ,9,6,3,0,1070,Vodka,
355,7791250000000,Smirnoff Citric ruby orange & lime,8,8,0,0,1070,Vodka,
356,7791250000000,Smirnoff Citric tangerine & lemongrass,6,6,0,0,1070,Vodka,
357,7791250000000,Smirnoff Limon,10,8,2,0,1070,Vodka,
358,7791250000000,Smirnoff Manzana ,36,34,2,0,1070,Vodka,
359,7791250000000,Smirnoff Raspberry,28,24,4,0,1070,Vodka,
360,7791250000000,Smirnoff regular,12,8,4,0,1070,Vodka,
361,7791250000000,Smirnoff Watermelon ,8,8,0,0,1070,Vodka,
362,5010110000000,Ballantines Finest Azul,4,3,1,1291,2650,whisky,
363,80432402733,Chivas Regal 12 anios 500ml,1,1,0,1620,3900,whisky,
364,7791250000000,J & B 6 anios,2,0,2,1650,2540,whisky,
365,82184090466,Jack Daniels,7,3,4,3835,6500,whisky,
366,5011010000000,Jameson 6 anios,2,0,2,1644,3900,whisky,
367,5000270000000,Johnnie Walker Black Label 750ml,4,3,1,4050,6200,whisky,
368,5000270000000,Johnnie Walker red label 1L ,2,0,2,2799,4300,whisky,
369,5000270000000,Johnnie Walker Red label 750ml,1,1,0,2353,3600,whisky,
370,7791250000000,Vat 69,2,1,1,670,1130,whisky,
371,7791250000000,Vat 69 apple,1,0,1,702,1130,whisky,
372,7791250000000,Vat 69 honey,1,0,1,702,1130,whisky,
373,7791250000000,White Horse,2,1,1,1040,1600,whisky,
